ācārya : ācā-rya
Ācārya : Ācā-rya
ācāryas : ācā-ryas
Adānta : Adān-ta
Adi : Adi
āhur : āhur
amongst : amongst
ānandāmbudhi : ān-an-dām-budhi
aparādhīs : apa-rādh-īs
ārati : āra-ti
avadhūta : ava-dhū-ta
Bābājī : Bā-bā-jī
Bagh : Bagh
bahūnāṁ : ba-hū-nāṁ
BBT : BBT
benedicting : be-ne-dic-ting
Bhagavad : Bha-ga-vad
Bhāgavata : Bhā-ga-va-ta
Bhāgavatam : Bhā-ga-va-tam
Bhāgavatams : Bhā-ga-va-tams
bhaja : bha-ja
Bhaja : Bha-ja
bhajana : bha-ja-na
bhakta : bhak-ta
Bhakta : Bhak-ta
bhaktas : bhak-tas
Bhaktavatsala : Bhak-ta-vat-sa-la
bhakti : bhak-ti
Bhakti : Bhak-ti
Bhaktibhūṣaṇa : Bhak-ti-bhū-ṣa-ṇa
Bhaktisiddhānta : Bhak-ti-sid-dhān-ta
Bhaktisiddhānta's : Bhak-ti-sid-dhān-ta's
Bhaktivaibhava : Bhak-ti-vai-bha-va
Bhaktivinoda : Bhak-ti-vi-no-da
bhava : bha-va
Bielefeld : Biele-feld
bija : bija
bīja : bīja
bol : bol
Bolo : Bolo
bona : bona
brahma : brahma
brahmacārī : brah-ma-cā-rī
brāhmaṇa : brāh-ma-ṇa
brāhmaṇah : brāh-ma-ṇah
brāhmaṇas : brāh-ma-ṇas
br : br
bṛhad : bṛ-had
Bṛhad : Bṛ-had
cafés : cafés
Caitanya : Cai-ta-nya
Caitanya's : Cai-ta-nya's
cakra : cak-ra
Cakra : Cak-ra
Cāṇakya : Cā-ṇa-kya
caritāmṛta : ca-ri-tā-mṛ-ta
caritāmṛtas : ca-ri-tā-mṛ-tas
Dāmodara : Dā-mo-da-ra
darśana : dar-śa-na
dāsa : dāsa
Daśāvatāra : Da-śā-va-tā-ra
dearmost : dear-most
dehinām : de-hi-nām
devī : devī
dhāmopagate : dhā-mo-pa-ga-te
Durgā : Dur-gā
durlabhā : dur-la-bhā
dvāram : dvā-ram
eva : eva
falldown : fall-down
fide : fide
fruitive : frui-tive
gañjā : gañ-jā
Garuḍa : Ga-ru-ḍa
Gauḍīya : Gau-ḍī-ya
Gaurāṅga : Gaur-āṅga
GBC : GBC
gitā : gitā
gītā : gītā
Gītā : Gītā
gītās : gītās
gobhir : go-bhir
Godbrothers : God-bro-thers
gopīs : gopīs
Gosāin : Go-sāin
Gosvāmī : Go-svā-mī
Gosvāmī's : Go-svā-mī's
Gosvāmīs : Go-svā-mīs
gosvāmism : go-svā-mism
Govinda : Go-vi-nda
grantha : gran-tha
granthi : gran-thi
Gṛhasthas : Gṛ-has-thas
gurukula : gu-ru-ku-la
handbound : hand-bound
handstretched : hand-stretch-ed
Hanumag : Ha-nu-mag
Haridāsa : Ha-ri-dā-sa
Hari : Hari
Harikeśa : Ha-ri-ke-śa
harināma : ha-ri-nā-ma
haṭṭa : haṭ-ṭa
haṭṭīs : haṭ-ṭīs
Henschels : Hen-schels
hṛdaya : hṛ-da-ya
imposters : im-pos-ters
irreligiosity : ir-re-li-gio-si-ty
ISKCON : ISKCON
Īśopaniṣad : Īśo-pa-ni-ṣad
iti : iti
Jagāi : Ja-gāi
Jagāis : Ja-gāis
Jagannātha : Ja-gan-nā-tha
Jāhnavā : Jāh-navā
jānātīti : jā-nā-tī-ti
janmanām : jan-ma-nām
Jaya : Jaya
Jhārikhanda : Jhā-ri-khan-da
Jīva : Jīva
jñānavān : jñā-na-vān
karmi : kar-mi
karmis : kar-mis
Kārttika : Kārt-ti-ka
kāruņikaḥ : kā-ru-ņi-kaḥ
kāruņikāḥ : kā-ru-ņi-kāḥ
kathā : ka-thā
Keśava : Ke-śa-va
kīrtana : kīr-ta-na
koro : koro
Koro : Koro
kṛṣṇa : kṛṣṇa
Kṛṣṇa : Kṛṣṇa
Kṛṣṇa's : Kṛṣṇa's
Kṛṣṇe : Kṛṣṇe
Kṣīrodakaśāyi : Kṣī-ro-da-ka-śā-yi
kunda : kund-a
lakhs : lakhs
lakṣmi : lakṣ-mi
lakṣmī : lakṣ-mī
latā : latā
layoutmen : lay-out-men
lilā : lilā
lilāmṛta : li-lāmṛ-ta
Linotypes : Li-no-types
Locana : Lo-ca-na
lotās : lot-ās
Mādhāi : Mā-dhāi
Mādhāis : Mā-dhāis
Mādhava : Mā-dha-va
mahājanas : ma-hā-ja-nas
mahā : mahā
Mahāprabhu : Ma-hā-pra-bhu
Mahāprabhu's : Ma-hā-pra-bhu's
Mahārāja : Ma-hā-rā-ja
Mahārājas : Ma-hā-rā-jas
Mahat : Ma-hat
māhātmya : mā-hāt-mya
Maṭha : Maṭha
mātra : māt-ra
mātraṁ : māt-raṁ
mayaivaite : ma-yai-vai-te
māyā : māyā
Mayapur : Maya-pur
Māyāvādi : Mā-yā-vā-di
Māyāvādīs : Mā-yā-vā-dīs
medhasaḥ : me-dha-saḥ
mlecchas : mle-cchas
Mohndruck : Mohn-druck
mṛdanga : mṛ-dan-ga
mundaner's : mun-da-ner's
nāma : nāma
Narottama : Na-rot-tama
Navadvīpa : Na-va-dvī-pa
nihatāḥ : ni-ha-tāḥ
Nimāi : Nimāi
nimitta : ni-mit-ta
Nityānanda : Nityā-nan-da
Nityānanda's : Nityā-nan-da's
nitya : ni-tya
nonmoving : non-mo-ving
organisational : or-ga-ni-sa-tion-al
Paṇḍita : Paṇ-ḍi-ta
Paṇḍita's : Paṇ-ḍi-ta's
Parabrahman : Pa-ra-brah-man
Paramātmā : Pa-ra-mā-tmā
paramparā : pa-ram-pa-rā
parikrama : pa-ri-kra-ma
Parīkṣit : Pa-rī-kṣit
pāya : pāya
Prabhupāda : Pra-bhu-pā-da
Prabhupāda's : Pra-bhu-pā-da's
Prabhu : Pra-bhu
Prahlāda : Pra-hlā-da
prapadyate : pra-pa-dya-te
prasādam : pra-sā-dam
prasāde : pra-sā-de
prāyair : prā-yair
pūjā : pūjā
pūjārī : pū-jā-rī
Purāņas : Pu-rā-ņas
pūrvam : pūr-vam
Rādhā : Rā-dhā
Rādhārāṇī : Rā-dhā-rā-ṇī
rasāmṛta : ra-sā-mṛ-ta
rasa : rasa
rāsa : rāsa
Ratha : Ratha
reciprocator : re-ci-pro-ca-tor
religionists : re-li-gion-ists
Rettershof : Ret-ter-shof
Rūpa : Rūpa
sācin : sācin
samādhi : sa-mā-dhi
Samādhi : Sa-mā-dhi
samādhis : sa-mā-dhis
sampradāya : sam-pra-dā-ya
Sanātana : Sa-nā-ta-na
saṅkīrtana : saṅ-kīr-ta-na
Saṅkīrtana : Saṅ-kīr-ta-na
saṅkīrtaners : saṅ-kīr-ta-ners
sannyāsa : san-nyā-sa
sannyāsī : san-nyā-sī
sannyāsīs : sann-yā-sīs
Sarasvatī : Sa-ra-sva-tī
sarvam : sar-vam
sarva : sar-va
sa : sa
Sāstra : Sā-stra
śāstra : śā-stra
savya : sa-vya
sevām : sevām
siddha : sid-dha
śikṣā : śi-kṣā
sindhu : sin-dhu
Śrīla : Śrī-la
Śrīmad : Śrī-mad
Śrīmati : Śrī-ma-ti
Śrīmatī : Śrī-ma-tī
Śrīnivāsa : Śrī-ni-vās-a
Śri : Śri
Śrī : Śrī
Śrīvāsa : Śrī-vā-sa
Sucandra : Su-cand-ra
Sudarśana : Su-dar-śa-na
śūdra : śūd-ra
suhṛdaḥ : su-hṛ-daḥ
Śukadeva : Śu-ka-de-va
Supersoul : Su-per-soul
su : su
sva : sva
Tamāla : Ta-mā-la
tamisram : ta-mis-ram
Ṭhākura : Ṭhā-ku-ra
Titikṣavaḥ : Ti-ti-kṣa-vaḥ
titikșavaḥ : ti-ti-kșa-vaḥ
Ulm : Ulm
Vaikuṇṭha : Vai-kuṇ-ṭha
Vaiṣṇavas : Vaiṣ-ṇa-vas
Vaiṣṇava : Vaiṣ-ṇa-va
Vaiṣṇavism : Vaiṣ-ṇ-avism
vaiśya : vai-śya
vardhanam : var-dha-nam
varņāśrama : va-rņāśra-ma
vāsudevaḥ : vā-su-de-vaḥ
Vedāntists : Ve-dān-tists
Vedāntist : Ve-dān-tist
Vedic : Ve-dic
vilāsa : vi-lā-sa
vimukteḥ : vi-muk-teḥ
viśatāṁ : vi-śa-tāṁ
Viṣṇupāda : Viṣ-ṇu-pā-da
Viṣṇu : Viṣ-ṇu
Vṛndāvana : Vṛn-dā-va-na
vyāsāsana : vyā-sā-sa-na
Vyāsa : Vyāsa
walkie : walkie
yajanti : ya-jan-ti
Yajñaiḥ : Ya-jñaiḥ
yajña : yajña
yātrā : yā-trā
yavanas : ya-va-nas
yuga : yuga
Yuga : Yuga
Acārya : Acā-rya
adhikārī : adhi-kā-rī
ajāta : ajā-ta
Aṅgirā : Aṅ-gi-rā
bhārata : bhā-ra-ta
bhūṣaṇāḥ : bhū-ṣa-ṇāḥ
bhūtāni : bhū-tā-ni
brahminical : brah-mi-ni-cal
breadsticks : bread-sticks
buddhir : bud-dhir
Caitanya's : Cai-ta-nya's
Cakravarti : Cak-ra-var-ti
devotionally : de-vo-tion-ally
ekeha : eke-ha
enjoyer : en-joy-er
Gaura : Gau-ra
grāmya : grā-mya
gṛhastha : gṛha-stha
japa : ja-pa
kaniṣṭha : ka-ni-ṣṭha
kāruṇikāḥ : kā-ru-ṇi-kāḥ
kicharī : ki-cha-rī
Kṛṣṇaloka : Kṛ-ṣṇa-lo-ka
Kṛṣṇas : Kṛṣṇas
kuru : ku-ru
madhya : ma-dhya
Māyāvāda : Mā-yā-vā-da
mindedly : minded-ly
Muni : Muni
nahe : nahe
nandana : nan-da-na
Nārada : Nā-ra-da
Nitāi : Ni-tāi
nonenvious : non-envi-ous
paran : pa-ran
paricīyate : pa-ri-cī-ya-te
Perón's : Pe-rón's
phalena : pha-le-na
pravartana : pra-var-ta-na
Rahhh : Rahhh
rahhhs : rahhhs
Ṛṣi : Ṛṣi
sādhavaḥ : sā-dha-vaḥ
śakti : śak-ti
sammohaṁ : sam-mo-haṁ
śāntāḥ : śān-tāḥ
śatravaḥ : śa-tra-vaḥ
tapa : tapa
tāra : tāra
Ṭhākura's : Ṭhā-ku-ra's
titikṣavaḥ : ti-ti-kṣa-vaḥ
varṇāśrama : var-ṇā-śra-ma
vidyā : vi-dyā
vinā : vinā
Viśvanātha : Vi-śva-nā-tha
Vyāsadeva : Vyā-sa-de-va
vyavasāyātmikā : vya-va-sā-yātmi-kā
yajñaiḥ : yajñaiḥ
yānti : yān-ti
yantras : yan-tras
dvandva : dvan-dva
dveṣa : dve-ṣa
icchā : ic-chā
mohena : mo-he-na
samutthena : sa-mut-the-na
āraṇyaka : āra-ṇya-ka
BBT's : BBT's
beadbag : bead-bag
bhāgavatāmṛta : bhā-ga-va-tāmṛ-ta
Bhava : Bha-va
capātīs : ca-pā-tīs
caturdaśī : ca-tur-da-śī
ceta : ceta
Ceto : Ceto
conchshell : conch-shell
darpaṇa : dar-pa-ṇa
dāsī : dā-sī
dāvāgni : dā-vā-gni
doṣānudarśanam : do-ṣā-nu-dar-śa-nam
duḥkha : duḥ-kha
Fruitive : Fruit-ive
gama : gama
Goloka : Goloka
Gopa : Gopa
Harināmānanda : Ha-ri-nā-mā-nan-da
janma : jan-ma
Janmāṣṭamī : Jan-mā-ṣṭa-mī
jarā : jarā
jyotir : jyo-tir
karmī : kar-mī
karmīs : kar-mīs
krpā : krpā
Kumāra : Ku-mā-ra
Kurukṣetra : Ku-ru-kṣe-tra
mandira : man-d-ira
Mandira : Man-di-ra
mārga : mār-ga
Mārga : Mār-ga
mārjanaṁ : mār-ja-naṁ
Māyādevī : Mā-yā-d-evī
mṛtyu : mṛ-tyu
nirvāpaṇaṁ : nir-vā-pa-ṇaṁ
nonsenses : non-senses
Nṛsiṁha : Nṛ-siṁ-ha
Prasādam : Pra-sād-am
pūrnimā : pūr-ni-mā
rathis : ra-this
Rohiṇī : Ro-hi-ṇī
Rohiṇīsuta : Ro-hi-ṇī-suta
Sakhīs : Sa-khīs
saṁsāra : saṁ-sā-ra
saṅkīrtaner : saṅ-kīr-ta-ner
saṅkīrtaners : saṅ-kīr-ta-ners
suta : suta
tamasi : ta-ma-si
Transcendentalize : Trans-cen-den-ta-li-ze
unlimitedly : un-li-mi-ted-ly
Upaniṣad : Upa-ni-ṣad
vyādhi : vyā-dhi
wishy : wi-shy
emsp : emsp
Bhagavān : Bha-ga-vān
bhāva : bhā-va
bruyāt : bru-yāt
disciplic : di-sci-plic
Ekādaśī : Ekādaśī
evādhikāras : evā-dhi-kā-ras
Hanumān : Ha-nu-mān
kadācana : ka-dā-ca-na
karmaṇy : kar-ma-ṇy
Karṇa : Kar-ṇa
kṣatriya : kṣa-tri-ya
Kṣīrodakaśāyī : Kṣī-ro-da-ka-śā-yī
Maṇidhara : Ma-ṇi-dha-ra
nondevotional : non-de-vo-tion-al
palatably : pa-la-tably
phaleṣu : pha-le-ṣu
prākṛta : prā-kṛ-ta
Prākṛta : Prā-kṛ-ta
prākṛta : prā-kṛ-ta
prapadyante : pra-pa-dyan-te
prema : pre-ma
priyaṁ : pri-yaṁ
Rāmacandra : Rā-ma-can-dra
satyaṁ : sat-yaṁ
Savyasācī : Sa-vya-sā-cī
śūdras : śūd-ras
taṭastha : ta-ṭa-stha
te : te
vaiśyas : vai-śyas
varṇa : var-ṇa
weakheartedness : weak-heart-ed-ness
yathā : ya-thā
crowlike : crow-like
crunchies : crun-chies
dānam : dā-nam
Darwinistic : Dar-wi-nis-tic
divyam : div-yam
grāma : grā-ma
haibe : hai-be
mora : mo-ra
mundaners : mun-da-ners
nagarādi : na-ga-rādi
nonvegetarians : non-ve-ge-ta-rians
paramahaṁsas : pa-ra-ma-haṁ-sas
Paramahaṁsas : Pa-ra-ma-haṁ-sas
pracāra : pra-cā-ra
pṛthivīte : pṛ-thi-vī-te
Rajneesh : Raj-neesh
sarvatra : sar-va-tra
Satya : Sat-ya
swanlike : swan-like
tapo : tapo
yata : yata
āsana : āsa-na
asuras : asuras
Asuras : Asu-ras
dhāraṇā : dhā-ra-ṇā
dhyāna : dhyā-na
īśvara : īś-va-ra
knower : know-er
māyā's : mā-yā's
nescience : ne-scien-ce
param : pa-ram
prāṇāyāma : prā-ṇā-yā-ma
worshipable : wor-ship-able
duḥkhī : duḥ-khī
else's : else's
Inishrath : Inish-rath
mandāḥ : man-dāḥ
sahajiyā : sa-ha-ji-yā
unrestrictedly : un-res-tric-ted-ly
anarthas : anar-thas
bhaktin : bhak-tin
brahmacārīs : brah-ma-cā-rīs
falldowns : fall-downs
jñānīs : jñān-īs
Korsnäs : Kors-näs
mātāji : mā-tā-ji
mātājīs : mā-tā-jīs
onwards : on-wards
opulences : opu-len-ces
overendeavor : over-en-dea-vor
sādhana : sā-dha-na
saṅga : saṅ-ga
titikṣasva : ti-ti-kṣa-sva
Vāṇī : Vā-ṇī
th : th
adhikārīs : adhi-kā-rīs
Aghāsura : Aghā-su-ra
ājñāya : ājñā-ya
āmāra : āmā-ra
Annus : An-nus
āśrama : āś-ra-ma
āśramas : āś-ra-mas
ba : ba
Bhaktivedanta : Bhak-ti-ve-dan-ta
brahmacāriṇi : brah-ma-cā-ri-ṇi
ci : ci
congregationally : con-gre-ga-tion-ally
conv : conv
daṇḍavats : daṇ-ḍa-vats
DDR : DDR
dekha : de-kha
deśa : de-śa
ei : ei
Gokula : Go-ku-la
hañā : ha-ñā
harināmas : ha-ri-nā-mas
horribilis : hor-ri-bi-lis
inebriety : ine-bri-ety
kaha : ka-ha
līlā : lī-lā
Madhya : Ma-dhya
maṅgala : maṅ-ga-la
mṛdaṅga : mṛ-daṅ-ga
mukhya : mu-khya
nija : ni-ja
Philos : Phi-los
ple : ple
prin : prin
pūjārīs : pū-jā-rīs
rathī : ra-thī
sence : sence
ses : ses
stonelike : stone-like
subsub : subsub
sūtra : sūt-ra
sūtras : sūt-ras
ty : ty
upadeśa : upa-de-śa
util : util
uttama : ut-ta-ma
vairāgya : vai-rā-gya
Vedavyāsa : Ve-da-vyā-sa
vṛtti : vṛt-ti
yāre : yā-re
BBTs : BBTs
Goswami : Go-swa-mi
BHAJAN : BHA-JAN
GAURANGA : GAUR-ANGA
HARI : HARI
LPs : LPs
Puṣpa : Puṣ-pa
RASA : RA-SA
SRI : SRI
Śrīdhāma : Śrī-dhā-ma
Varṇāśrama : Varṇāśrama
